..........#.........
..........#.........
..........#.........
..........#.........
....................
..........##########
....................
....###.............
......##............
....................
